##############
# ..........G#
#.####.#####.#
#.#  #.#   #.#
#.####.#####.#
#............#
#.####.##.####
#.####.##.####
#......##....#
######.#####.#
#    #.##### #
#    #.##    #
#    #.## ####
######.## ####
#     .  P####
##############
